    #####
    #---#
    #---#
  ###---##
  #------#
###-#-##-#   ######
#---#-##-#####----#
#-----------------#
#####----.$@##----#
    #-----#########
    #######