##########   ######
#--------#####.-$-#
#@#---------------#
#####$------##--$.#
    #.----#########
    #######