    #####
    #---#
    #$--#
  ###--$##
  #--$-$-#
###-#-##-#   ######
#---#-##-#####--..#
#-$--$----------..#
#####-###-#@##--..#
    #-----#########
    #######