 ###  #############
##@####-------#---#
#-$$---$$--$-$-...#
#--$$$#----$--#...#
#-$---#-$$-$$-#...#
###---#--$----#...#
#-----#-$-$-$-#...#
#----######-###...#
##-#--#--$-$--#...#
#--##-#-$$-$-$##..#
#-..#-#--$------#.#
#-..#-#-$$$-$$$-#.#
#####-#-------#-#.#
    #-#########-#.#
    #-----------#.#
    ###############