          ####
     #### #--#
   ###-@###$-#
  ##------$--#
 ##--$-$$##-##
 #--#$##-----#
 #-#-$-$$-#-###
 #---$-#--#-$-#####
####----#--$$-#---#
####-##-$---------#
#.----###--########
#..-..# ####
#...#.#
#.....#
#######