################
#--------------#
#-#-######-----#
#-#--$-$-$-$#--#
#-#---$@$---##-##
#-#--$-$-$###...#
#-#---$-$--##...#
#-###$$$-$-##...#
#-----#-##-##...#
####----##-##...#
   ######-----###
        #-----#
        #######