   #########
  ##---##--######
###-----#--#----###
#--$-#$-#--#--...-#
#-#-$#@$##-#-#.#.-#
#--#-#$--#----.-.-#
#-$----$-#-#-#.#.-#
#---##--##$-$-.-.-#
#-$-#---#--#$#.#.-#
##-$--$---$--$...-#
 #$-######----##--#
 #--#    ##########
 ####