       #######
 #######-----#
 #-----#-$@$-#
 #$$-#---#########
 #-###......##---#
 #---$......##-#-#
 #-###......-----#
##---####-###-#$##
#--#$---#--$--#-#
#--$-$$$--#-$##-#
#---$-$-###$$-#-#
#####-----$---#-#
    ###-###---#-#
      #-----#---#
      ########--#
             ####