   ########
   #---#--#
   #--$---#
 ###-#$---####
 #--$--##$---#
 #--#-@-$-#-$#
 #--#------$-####
 ##-####$##-----#
 #-$#.....#-#---#
 #--$..%%.-$#-###
##--#.....#---#
#---###-#######
#-$$--#--#
#--#-----#
######---#
     #####