#####
#---##
#----#  ####
#-$--####--#
#--$$-$---$#
###@-#$----##
 #--##--$-$-##
 #-$--##-##-.#
 #--#$##$--#.#
 ###---$..##.#
  #----#.%...#
  #-$$-#.....#
  #--#########
  #--#
  ####