   ##########
   #..--#---#
   #..------#
   #..--#--####
  #######--#--##
  #------------#
  #--#--##--#--#
####-##--####-##
#--$--#####-#--#
#-#-$--$--#-$--#
#-@$--$---#---##
####-##-#######
   #----#
   ######