     ###########
     #--.--#---#
     #-#.----@-#
 #####-##..#-####
##--#-..###-----###
#-$-#...---$-#--$-#
#----..-##--##-##-#
####$##$#-$-#---#-#
  ##-#----#$-$$-#-#
  #--$-#-#--#-$##-#
  #---------------#
  #--###########--#
  ####         ####