  ######
  #---@####
#####-$---#
#---##----####
#-$-#--##----#
#-$-#--#####-#
##-$--$----#-#
##-$-$-###-#-#
##-#--$--#-#-#
##-#-#$#---#-#
##-###---#-#-######
#--$--####-#-#....#
#----$----$---..#.#
####$--$#-$---....#
#-------#--##-....#
###################