############
#..--#-----###
#..--#-$--$--#
#..--#$####--#
#..----@-##--#
#..--#-#--$-##
######-##$-$-#
  #-$--$-$-$-#
  #----#-----#
  ############