    ##########
#####--------####
#-----#---$--#@-#
#-#######$####--###
#-#----##-#--#$-..#
#-#-$-----#--#--#.#
#-#-$--#-----#$-..#
#-#--###-##-----#.#
#-###--#--#--#$-..#
#-#----#--####--#.#
#-#$---$--$--#$-..#
#----$-#-$-$-#--#.#
####-$###----#$-..#
   #----$$-###....#
   #------## ######
   ########