#########
#-------#
#-------####
##-####-#--#
##-#@##----#
#-$$$-$--$$#
#--#-##-$--#
#--#-##--$-####
####--$$$-$#--#
 #---##---....#
 #-#---#-#..-.#
 #---#-#-##...#
 #####-$--#...#
     ##---#####
      #####