######     ####
#----#######--#####
#---$#--#--$--#---#
#--$--$--$-#-$-$--#
##$-$---#-@#-$----#
#--$-###########-##
#-#---#.......#-$#
#-##--#-......#--#
#-#---$........$-#
#-#-$-#....-..#--#
#--$-$####$####-$#
#-$---###-$---$--##
#-$-----$-$--$----#
##-######-$-#####-#
#---------#-------#
###################