    #######
    #--#--####
#####-$#$-#--##
#..-#--#--#---#
#..-#-$#$-#--$####
#.--#-----#$--#--#
#..---$#--#-$----#
#..@#--#$-#$--#--#
#..-#-$#-----$#--#
#..-#--#$$#$--#--##
#..-#-$#--#--$#$--#
#..-#--#--#---#---#
##.-####--#####---#
 ####  ####   #####