###############
#..........--.####
#..........$$.#--#
###########$-#---##
#------$--$-----$-#
##-####---#--$-#--#
#------#---##--#-##
#--$#--#-##--###-##
#-$-#$###----###-##
###--$-#--#--###-##
###----$-##-#--#-##
 #-$--#--$--$-$---#
 #--$--$#$$$--#---#
 #--#--$------#####
 #-@##--#--#--#
 ##############