####
#--##############
#--#---..#......#
#--#-#-#####-...#
##$#----........#
#---##$######--####
#-$-#-----######@-#
##$-#-$---######--#
#--$-#$$$##-------#
#------#----#$#$###
#-####-#$$$$$----#
#-#----$-----#---#
#-#---##--------###
#-######$######-$-#
#--------#    #---#
##########    #####