 #######
 #--#--#####
##--#--#...###
#--$#--#...--#
#-$-#$$-...--#
#--$#--#...-.#
#---#-$########
##$-------$-$-#
##--#--$$-#---#
 ######--##$$@#
      #------##
      ########