 #################
 #...---#----#---##
##.....--$##-#-#$-#
#......#--$--#----#
#......#--#--#-#--#
#########-$--$-$--#
  #-----#$##$-##$##
 ##---$----#-$----#
 #--##-###-#--##$-#
 #-$-$$-----$--$--#
 #-$----$##$-######
 #######--@-##
       ######