         #####
     #####---#
    ##-$--$--####
#####-$--$-$-##.#
#-------$$--##..#
#--######-###..-#
##-#--#----#...-#
#-$---#----#...-#
#@-#$-##-####...#
####--$-$$--##..#
   ##--$-$--$...#
    #-$$--$-#--.#
    #---$-$--####
    ######---#
         #####