#####
#---##
#-$--#########
##-#-#-------######
##-#---$#$#@--#---#
#--#------$-#---$-#
#--###-#########-##
#--##-..%.....-#-##
##-##-%.%..%.%-#-##
#-$##########-##$-#
#--$---$--$----$--#
#--#---#---#---#--#
###################