        ########
        #-----@#
        #-$#$-##
        #-$--$#
        ##$-$-#
#########-$-#-###
#....--##-$--$--#
##...----$--$---#
#....--##########
########