       ###########
       #---#-----#
#####  #-----$-$-#
#---#####-$##-#-##
#-$-##---#-##-$--#
#-$--@$$-#-##$$$-#
##-###---#-##----#
##-#---###-#####$#
##-#-----$--#....#
#--###-##-$-#....##
#-$---$-#---#..$.-#
#--##-$-#--##....-#
#####---######...##
    #####    #####