        #####
        #---#####
        #-#$##--#
        #-----$-#
#########-###---#
#....--##-$--$###
#....----$-$$-##
#....--##$--$-@#
#########--$--##
        #-$-$--#
        ###-##-#
        #------#
        ########