######  ###
#..--# ##@##
#..--###---#
#..-----$$-#
#..--#-#-$-#
#..###-#-$-#
####-$-#$--#
   #--$#-$-#
   #-$--$--#
   #--##---#
   #########