       #####
 #######---##
##-#-@##-$$-#
#----$------#
#--$--###---#
###-#####$###
#-$--###-..#
#-$-$-$-...#
#----###...#
#-$$-# #...#
#--### #####
####