  ####
  #--###########
  #----$---$-$-#
  #-$#-$-#--$--#
  #--$-$--#----#
###-$#-#--####-#
#@#$-$-$--##---#
#----$-#$#---#-#
#---$----$-$-$-#
#####--#########
  #------#
  #------#
  #......#
  #......#
  #......#
  ########