          #######
          #--...#
      #####--...#
      #------.-.#
      #--##--...#
      ##-##--...#
     ###-########
     #-$$$-##
 #####--$-$-#####
##---#$-$---#---#
#@-$--$----$--$-#
######-$$-$-#####
     #------#
     ########